    ######   
   #      #  
  # P   #### 
 #   X  o  O#
 ############